border_size=1
usage=map

Xu          , Xu          , Rd          , Rd          , Rd          , Xu          , Xu          , Xu          , Re          , Xu          , Xu          , Xu          , Xu          , Xu          , Rd          , Xu          , Xu          , Xu          , Xu          , Xu          , Xu          , Xu          
Xu          , Xu          , Rd          , Rd          , Rd          , Xu          , Xu          , Rd          , Xu          , Xu          , Xu          , Xu          , Xu          , Re          , Re^Dr       , Re          , Re          , Rd          , Rd          , Xu          , Xu          , Xu          
Xu          , Xu          , Rd          , Rd          , Rd          , Rd          , Rd          , Rd          , Xu          , Xu          , Xu          , Xu          , Xu          , Xu          , Xu          , Xu          , Xu          , Rd          , Rd          , Xu          , Re          , Xu          
Xu          , Xu          , Rd          , Rd          , Rd          , Rd          , Re^Dr       , Re          , Re          , Xu          , Xu          , Xu          , Xu          , Xu          , Xu          , Xu          , Xu          , Re          , Rd          , Rd          , Xu          , Xu          
Xu          , Xu          , Rd          , Rd          , Rd          , Rd          , Xu          , Xu          , Xu          , Xu          , Xu          , Xu          , Xu          , Xu          , Xu          , Xu          , Xu          , Xu          , Rd          , Re          , Xu          , Xu          
Xu          , Rd          , Rd          , Rd          , Rd          , Rd          , Xu          , Xu          , Xu          , Xu          , Xu          , Xu          , Xu          , Xu          , Xu          , Xu          , Xu          , Xu          , Rd          , Xu          , Xu          , Xu          
Xu          , Re^Dr       , Rd          , Rd          , Rd          , Rd          , Xu          , Xu          , Xu          , Xu          , Rd          , Xu          , Xu          , Xu          , Xu          , Rd          , Re          , Rd          , Re          , Xu          , Xu          , Xu          
Xu          , Xu          , Rd          , Rd          , Rd          , Rd          , Xu          , Xu          , Xu          , Xu          , Rd          , Xu          , Xu          , Xu          , Xu          , Rd          , Xu          , Re^Dr       , Xu          , Xu          , Xu          , Xu          
Xu          , Xu          , Rd          , Rd          , Rd          , Rd          , Rd          , Rd          , Xu          , Rd          , Rd          , Xu          , Rd          , Xu          , Rd          , Rd          , Xu          , Xu          , Qxu         , Qxu         , Qxu         , Qxu         
Xu          , Rd          , Rd          , Rd          , Rd          , Rd          , Rd          , Rd          , Rd          , Rd          , Rd          , Rd          , Rd          , Rd          , Rd          , Rd          , Rd          , Qxu         , Qxu         , Qxu         , Qxu         , Qxu         
Xu          , Re          , Re^Dr       , 1 Cud       , Re^Dr       , Re          , Re^Dr       , Re          , Re          , Re          , Re^Dr       , Re          , Re          , Re          , Re^Dr       , Re          , Re^Dr       , Re          , Qxu         , Qxu         , Qxu         , Qxu         
Xu          , Xu          , Xu          , Xu          , Xu          , Xu          , Xu          , Xu          , Xu          , Xu          , Xu          , Xu          , Xu          , Xu          , Xu          , Xu          , Xu          , Xu          , Xu          , Xu          , Xu          , Xu          
